%%%%%%%%%%%%%%%%%
%P      %       %
% % % % % %%%%% %
% % % % % %   % %
% %%%%% % %   % %
%     % % %   % %
%%%%% % % % %%% %
%  G  %   %     %
% %%% %%% % %%% %
% % %   % % % % %
% % %%% % % % %%%
% %   % % %    .%
% %G% % %%% %%%%%
% % % % % G %   %
%%% %%% % %%%%% %
%       %       %
%%%%%%%%%%%%%%%%%